1111111
1000001
1000001
1000001
10C0011
1P001E1
1000001
1000001
1000001
1111111
