11111111111111111111
1000000000000001CCC1
111110111111100000C1
10C00000C00C11111001
1000000C0000C00C1E01
100C11111C0000001111
100000C00000011000C1
100110000000C11C0001
1000C000000001100001
100000000000C11C0001
100C11C0000001100001
100C11C0000000C00001
10000000000000000001
10000000PC10000C11C1
11111111111111111111
